%%%%%%%%%%%%%%%%%%%%
%        P         %
%%%%%%%%%%%%%%%%%% %
%.....             %
%%%%%%%%%%%%%%%%%%%%
